1111111
1EEE011
1C00P01
1111111
1111111