1111111
1PEEC11
1CCCE01
1111111




